type octile
height 5
width 5
map
TTTTT
T.T.T
T.T.T
T...T
TTTTT
