type octile
height 9
width 10
map
TTTTTTTTTT
T...T....T
T...T...TT
T....T...T
T...T....T
T........T
TTT...T.TT
T..T.....T
TTTTTTTTTT